1111111111111
1P010000000C1
1000011111001
1000011111E01
1111111111111