111111111111111111111
1P0000000000000C00001
100111111011110111001
1000000000C00000M0001
111101111111011110101
1000010000000000C0001
101111011111101111101
1C00000000M00000000E1
101111101111101011111
100C000C0000000000001
100011101111101111101
1000M0000000C00000001
101111111101111101111
100000000000C00000M01
100001111101111111101
10C000000000000000001
101011101111101110101
100000000000000000001
101000001C10000001101
111111111111111111111